TOyiiZXICIE	Karate	Nocny Kochanek	rm
JhghCaPHgEs	1 Up	Rucka Rucka Ali	rm
A6hMW29cpJ8	1000 Doors	The Living Tombstone	rm
2rHRztFGOm8	1985	Bo Burnham	rm
JZD8GKREjCE	3-Way	The Lonely Island	rm
B6GdsRIbTSk	What's Up	4 Non Blondes	rm
AwN0Vqd764I	500 Chunks	TheGaming Matteo	rm
lhg9bYNLvOg	Thunderstruck	AC/DC	rm
I8LnIY8rOCA	A Complete History of the Soviet Union, Through the Eyes of a Humble Worker	Pig with the Face of a Boy	rm
ujui87ho7oA	Andrew Tate	Rucka Rucka Ali	rm
8ay_BkRuv-o	All Star	Smash Mouth	rm
z8WunrI7yh0	Art is dead	Bo Burnham	rm
lhUFIGTlX-4	BANG!	AJR	rm
tJgehE22_KA	Bogdan Boner: Egzorcysta	Ajronwejder	rm
Y7ch5Qj_oEY	Metalomobil	Ajronwejder	rm
OO21QhJqtaM	Naszym domem piekło	Ajronwejder 	rm
M7X8W1HbtRQ	World's Smallest Violin	AJR	rm
aBfoXrxJyMI	ALE Z CIEBIE BAMBIK!	przemekbestgames	rm
o0WWaA3oFa4	A Man Without Love	Engelbert Humperdinck	rm
ozcKdmjFE1I	Rave in the Grave	AronChupa, Little Sis Nora	rm
pe6Ch0mq7HI	A Songus Amongus	The Chalkeaters	rm
fEpjlJ45N5g	Autodancing	Cjalis	rm
nLfhkoB4D5k	Sail	Awolantion	rm
abz-YvKjLgY	Baby one more time	Jack Black	rm
9vWNauaZAgg	Back In Black	AC/DC	rm
FBw-Z8ULwcc	Back in the 90's	Grouplove	rm
iZmBh0MRPvs	Turn On The Camera	Bad History	rm
KYgK97aioNA	Who Let The Dogs Out	Baha Men	rm
dmHHjN5FJEo	Baka Mitai X Balls in Yur Jaws	The Taxi Driver	rm
skXTaWfMZGM	Bal jak bal	Bracia Figo Fagot	rm
5mf2vb4NzVk	Balls in Yur Jaws 2.0	Kornell Aka Piermid	rm
g-q29-tV6hw	Bamboleo	Bracia Figo Fagot	rm
BRD9BqjIk-E	Banana Man	Tally Hall	rm
Xm5LzlX-qfE	Beata Paulina	Bracia Figo Fagot	rm
KQgjHRwMPZQ	Beethoven Virus	Diana	rm
5AI44gnaLxY	Better Call Saul Main Title Theme	Little Barrie	rm
BBZrELBT8sI	Beverly Hills	Weezer	rm
EdqHgnGieeM	Big Chungus 2	Endigo	rm
rYi4Z0u-a9w	BIG CHUNGUS	Endigo	rm
pykeXH5GAt4	Big Iron	Marty Robbins	rm
RRLh3HDqRhQ	Bitwa	Cztery Refy	rm
CX3BKKxYTYw	Man's Not Hot	Big Shaq	rm
LOyHMftfbGA	Gonna Fly Now	Bill Conti	rm
ZD6rXLXZOEI	Bad guy	Billie Eilish	rm
6Dh-RL__uN4	Bitch lasagna	PewDiePie	rm
LrkEc2V3mO4	Lets Get Retarded	Black Eyed Peas	rm
6Phbb2O1icY	Hanging On The Telephone	Blondie	rm
kyzIQKuSqBs	Blue (Da Ba Dee)	Eiffel 65	rm
V2SVRJ6dcE4	Bones	Imagine Dragons	rm
XyL-beZoqos	Bowsette	The Chalkeaters	rm
zjPV08X84ME	Bożenka	Bracia Figo Fagot	rm
3vVSBLkpO-8	Baby I'm Yours	Breakbot	rm
cQzMHhRCTYw	Buddy Holly	Weezer	rm
MlzMHd3ctyE	Buraki	Kabanos	rm
Eq98aXOTYO4	Busted	Candace, Vanessa	rm
e2qG5uwDCW4	Buttercup	Jack Stauber, Jack Stauber	rm
fxHjlCBHuzA	Bye Bye Bye	*NSYNC	rm
QPXQyks5d2Q	Jerk It Out	Caesars Palace	rm
A67ZkAd1wmI	Caramelldansen	Caramella Girls	rm
dlObDivWgx8	Call Me Maybe	Carly Rae Jepsen	rm
2d87maMStso	Carmen, Act II: Votre toast, Toreador Song	Alan Titus	rm
ud5jkHTypFk	KICK BACK Cover	Jonathan Young	rm
F_TuSBUXgmE	Ridin'	Chamillionaire	rm
yoCoRYhPHkQ	Cheeki Breeki	The Chalkeaters	rm
DNgRHr2OWGE	Chłopcy radarowcy	Andrzej Koziński, Andrzej Rosiewicz	rm
PPfi7o2Pa64	Chug Jug With You (Number One Victory Royale)	LeviathanJPTV	rm
R3Xk4-KUWAg	Chungsmas songs for chungsmas	mg	rm
esF4aUD0KBs	Zayebały żule mi	TheChwytak	rm
lobriqWe3Pk	Ciągle pada	Czerwone Gitary	rm
IWfxvK18RXw	Ciuralla	Cjalis	rm
kJ2eoSpIcbM	Podwójna spluwa Egzorcysty	Cjalis	rm
C0nU-J031TY	NECRODŻENTELMENEL	Ajronwejder	rm
a-CwwPXQl7Q	U SIEBIE RÓB JAK U SIEBIE	Cjalis	rm
PHgc8Q6qTjc	Congratulations	PewDiePie	rm
70ocdx2SioY	Count to Three	The Chalkeaters	rm
iv7TrKrwteI	Cupid	FIFTY FIFTY	rm
ooy35xKTZtE	Czarny Chleb i Czarna Kawa	Strachy Na Lachy	rm
NroWYZc84XM	Czas na umieranie	Wojtek Szumański	rm
BUYLdVeny5g	You Spin Me Round	Dead Or Alive	rm
y4FiCl-tUJc	Demons	Imagine Dragons	rm
X0k5XUoO1y0	Dick In A Box	The Lonely Island	rm
0FvHyHaT8ys	Diggy Diggy Hole	Wind Rose	rm
MWQFEV-iJ5A	Disco Commando	Bracia Figo Fagot	rm
5Z56MZFMp0k	Discord	The Living Tombstone	rm
89dGC8de0CA	Dream on	Aerosmith	rm
3wtqy_dKDVM	Land Of Confusion	Disturbed	rm
mmCnQDUSO4I	Waltz No. 2	Dmitri Shostakovich	rm
APGBRDeqsSI	Don't Wanna Know	Bo Burnham	rm
QydzTeVCeAA	Doom Crossing: Eternal Horizons	The Chalkeaters	rm
rFkyVMDdRJk	Down's Syndrome Girl	Family Guy	rm
dEaVOgzS2Z8	Dozwolone do lat 18	Czerwone Gitary	rm
Za7j-pDnh2I	Do Ya Wanna Taste It	Wig Wam	rm
88s1MuNG0vg	Dzieci wybiegły	Elektryczne Gitary	rm
-OJ5G7gFVts	Dziewczyna z ptakiem	Bracia Figo Fagot	rm
_nqw0MW62uw	Egzorcysta Boner	Cjalis	rm
pTgnopftu-k	Elegancja Francja	Bracia Figo Fagot	rm
MBJFPq2Llps	Rap God	Eminem	rm
EWMPVn1kgIQ	Enormous Penis	Da Vinci's Notebook	rm
BIcM-AFP40o	Etyzer z kosmosu	Bracia Figo Fagot	rm
i5_asj1BGFs	Sweet Dreams	Eurythmics	rm
dyzYqi7hlPA	Fajter	Cjalis	rm
LOz2TSbmmhw	Shipoopi	Family Guy	rm
6XT60XaealA	Just The Two Of Us	Fanfare Ciocarlia	rm
dy9ugPD6_AE	It's been so long	The Living Tombstone	rm
OmKvVuEg5xE	Five Nights at Freddy's	The Living Tombstone	rm
yOzEeJZ92X8	Fly Me To The Moon	Frank Sinatra	rm
qSGWoYgrIuk	Fnaf 2	The 8-Bit Big Band	rm
rnO-MflYxCw	Pumped Up Kicks	Foster The People	rm
CqnU_sJ8V-E	Free Bird	Lynyrd Skynyrd	rm
Zf-A1d4hU3k	FUCK THIS SHIT IM OUT	YoungBlaze	rm
4YSVyA_CgKA	Furrýmon: Gotta Smash ’Em All!	The Chalkeaters	rm
9KnzkZCJi-w	Gdybym zgolił wąs	Bracia Figo Fagot	rm
ifNr1lOawX4	Gdy Nie Ma Dzieci	Kult	rm
E1BY0WVbC_c	Gender	Łydka Grubasa	rm
-5qqrMu_AZc	Gangsta's Paradise	Coolio	rm
c3Pd7nH7Y40	L'AMOUR TOUJOURS	GIGI D'AGOSTINO	rm
eEwV_53U0Sw	Ściernisko	Golec uOrkiestra	rm
NxxjLD2pmlk	Feel Good Inc.	Gorillaz	rm
zYrTYopOZws	Ech, poleczko	Guzowianki	rm
juYx5iA3rK4	Harnaś ice tea	Gawryle	rm
fg_68MBzpzQ	Hash Pipe	Weezer	rm
zsN-5KQ58Ew	Demons (TVA)	Hayley Kiyoko	rm
3Mr0pDNVms0	Heaven Knows I'm Miserable Now	The Smiths	rm
BunrJFs3g6Y	Here Comes My Arrow	How It Should Have Ended	rm
mBw3qzf4s18	HEYYEYAAEYAAAEYAEYAA	SLACKCiRCUS	rm
PIzBUwF0OUA	Historia wujka Wiesia	Bracia Figo Fagot	rm
vkHOLTEey0g	Hot Dog	Bracia Figo Fagot	rm
boxtYWyVNDE	Hot Milk	Snail's House	rm
Zrf3uxjWj6k	Ievan polkka	Riikka	rm
6eEnOk_C9wU	I Just Had Sex	The Lonely Island	rm
r2dosVRzLSM	I Just Threw Out The Love Of My Dreams	Weezer	rm
I203G1sMGDg	Bad Liar	ImagineDragons	rm
BahtnT13vH8	Machine	ImagineDragons	rm
hqAauanvEew	Zero	ImagineDragons	rm
jLdGDfcyI34	I'm always mean to jew	Rucka Rucka Ali	rm
wTssuRCH6XI	I'm Me	Vanessa	rm
nxmXoMuxpyk	I’m So Humble	The Lonely Island	rm
2aeICPCF-nI	Deja Vu	Initial D	rm
BLZWkjBXfN8	In The End	Linkin Park	rm
M9J6DKJXoKk	In The Virtual End	Ray Koefoed	rm
NRtnUVaRwXM	INVISIBLE	Duran Duran	rm
hX1SgxGhxqY	iPhones Gay	Rucka Rucka Ali	rm
yxNOLIAtEI4	Lil' Jon's Get Low Holly Jolly Christmas	Memes Worldwide	rm
Rbgw_rduQpM	I Really Want to Stay at Your House	Rosa Walton, Hallie Coggins	rm
DGk6kULEJtU	I love minorities	Rucka Rucka Ali	rm
AiIBKcd4m5Q	I Love You Baby	Frank Sinatra	rm
n-C0CWoirXs	I watch anime	Rucka Rucka Ali	rm
b3-QqGVt-tM	Iron Man	Black Sabbath	rm
beX-9wW5rL0	Island In The Sun	Weezer	rm
zRXl8Ow2bUs	It Just Works	The Chalkeaters	rm
7pq0cIBZCAY	It's Beginning to Look a Lot Like Chungsmas	Liam Lambert	rm
bY3vXr7fm8k	It's My Life	Bon Jovi	rm
TXK03FHVsHk	I've No More Fucks To Give	Thomas Benjamin Wild Esq	rm
85cqCA1DFmI	Jack Sparrow	The Lonely Island	rm
irHapqwtaII	Jagiełło	Bracia Figo Fagot	rm
wVTCfcCsgZU	Jessica	Borys LBD	rm
DplawA83a_k	Wiggle	Jason Derulo	rm
gnrSpwb2Ax4	Time In A Bottle	Jim Croce	rm
lrOUz6Um4Ps	Jizz In My Pants	The Lonely Island	rm
j360s9CtZTs	Juno	Sabrina Carpenter	rm
A6F0C1v3VeE	Babe I love you very much	Orbita Dupy	rm
k3_lNgBACb8	Karolino	Bracia Figo Fagot	rm
_leCDwul69I	Flamingo	Kero Kero Bonito	rm
NMA_isZYsYQ	KICK BACK	Kenshi Yonezu	rm
VHb_XIql_gU	Kids	MGMT	rm
V7CO3dYfKHs	Kill Yourself	Bo Burnham	rm
c_QeWGPnExc	Klocki	Kabanos	rm
A_Tttp9Jea8	Kocham piwo	Big Cyc	rm
7mg4rAxEtWw	Kolonia specjalna	Kuki	rm
t5QBipJEtHQ	Kołowrotek	Wojtek Szumański	rm
g6f9Dis7l78	Koń na białym rycerzu	Nocny Kochanek	rm
jxPbBdEfTqU	Królowa dzielni	Cjalis	rm
RQt0J0afgV8	Mój przyjacielu	Krzysztof Krawczyk	rm
ZDZjMs_5bZM	Kto By Pomyślał	Wojtek Szumański	rm
Wf8KaGnqV4U	Kukurydza	Lej Mi Pół	rm
DHcDLcO2Yp8	Baranek	Kult	rm
ccAUZgHnVtk	Brooklyńska rada żydów	Kult	rm
uNgfoCcmdPE	Łabędź	Lej Mi Pół	rm
1e32cgJrbBo	Bloody Mary	Lady Gaga	rm
5mHzaIehRTE	Lay All Your Love On Me	ABBA	rm
enPg09IpUjU	Lemon Tree	Fools Garden	rm
NOtLrcgJ0YM	Life online	Rucka Rucka Ali	rm
Jnjuk_yxDJk	Lifelight	Akano	rm
UadtlXKk1ek	Like a Prayer	Madonna	rm
ETEg-SB01QY	Little Dark Age	MGMT	rm
Y8B_a0ZHNj8	Little Girls	Oingo Boingo	rm
YBdyc1WDlBQ	Livin' On A Prayer	Bon Jovi	rm
cFaA3phn8dw	Llama In My Living Room	AronChupa, Little Sis Nora	rm
qMkwuz0iXQg	Low Rider	War	rm
N8rqVOSjjvU	Madziu, Magdo, Magdaleno	Bracia Figo Fagot	rm
WL8RaHNVXug	Majami	Lej Mi Pół	rm
NYUQI8x3zVk	Can Can World	Makkeroni	rm
Bmliz34QCZc	Makumba	Big Cyc	rm
eHA6ctzgFzQ	Malcziki	Yugoton	rm
nCqJrVGtLNA	Małgoś głupia	Bracia Figo Fagot	rm
Al26N5jkOjc	Mamo, jest mi tu dobrze	Kabanos	rm
l37LwK4v2PE	Mamuniu Miła	Bracia Figo Fagot	rm
pfjcAChy34o	Moskau	Dschinghis Khan	rm
fTFxE32onKs	Gas Gas Gas	Manuel	rm
tYvFa2ARD24	Uptown Funk	Mark Ronson	rm
_GU0y310dkk	Mars Napada	Kazik	rm
E2uPfJ_POgk	Teardrop	Massive Attack	rm
gDCRrvtY78g	U Can't Touch This	MC Hammer	rm
hfmxO-HQ5rU	Down Under	Men At Work	rm
_mMyPJSx8RU	Smooth Criminal	Michael Jackson	rm
Bsr8hb3TPBI	Cooler than me Lyrics	Mike Posner	rm
UAlIq7BKNxg	Mine All Day	PewDiePie	rm
V_NIU74wo18	Minecraft won't add inches to your cock	Rucka Rucka Ali	rm
ZZujisNZuw0	MINECRAFT CREEPER RAP	Dan Bull	rm
esXsbySzpqg	Minerał Fiutta	Nocny Kochanek	rm
1VPotzhpAGE	Misery Business	Paramore	rm
OFi8748c9Ew	Misery Fell	Tally Hall	rm
mKpsuGMeqHI	Misirlou	Dick Dale	rm
rwRsr-0CmAE	Morskie Opowieści	Piosenki Szantowe	rm
cqHkyxTdI58	Motherlover	The Lonely Island	rm
pLJ85XExZtQ	&	Tally Hall	rm
m2zUrruKjDQ	Mr. Brightside	The Killers	rm
vQKtPejZobA	Must Have Been the Wind	The Chalkeaters	rm
MURua52_YPg	My Ordinary Life	The Living Tombstone	rm
BtOGw8PINLU	Długość dźwięku samotności	Myslovitz	rm
Qp6D71kQRhA	My Way	Frank Sinatra	rm
_yzmNaY-TjE	Najebany to do domu	Bracia Figo Fagot	rm
6IdMp-H9vhA	Never Fade Away	SAMURAI	rm
iICsiArWmHI	Netherlands Gay	Rucka Rucka Ali	rm
WIw6ngJeuLU	Nie zadzieraj nosa	Czerwone Gitary	rm
a17pgn0qmXA	No Mercy	The Living Tombstone	rm
5qZQEq_C3vc	Numb	Linkin Park	rm
CUGC3ya2rfA	Otto Croy	Odjbox	rm
DSJzz0s0HsA	Can-Can	Jacques Offenbach	rm
9YpvNgCSaCU	Old Town Road	Lil Nas X	rm
2JwRWieRoeU	One More Pull	The Chalkeaters	rm
wsHbHR3Os6U	Oops!... I Did It Again	Britney Spears	rm
N_huCu7SChw	Opera Knishes	Travis Donnell	rm
XfZYgghMCGc	ORAJ POLE NA TRAKTORE!	Rolnicze Disco	rm
XZSeUP3Xee8	Ostatnia Nocka	Yugopolis	rm
FDzr-IFSJyc	Only 17	Rucka Rucka Ali	rm
f7P5Q2IIT4U	Dragostea Din Tei	O-Zone	rm
Ldlnzc7hl-E	Pa	Kabanos	rm
170sceOWWXc	Paint It, Black	The Rolling Stones	rm
wCMkE4vOPqs	Pakistański chłopiec	Bracia Figo Fagot	rm
m7nwbJLO9qo	Paranoid	Black Sabbath	rm
kmioyMNkgx4	LMFAO	Party Rock Anthem 	rm
5-Z-ODDOC7o	Pędzą sanie	kumarowaty	rm
Vk8UEWHYfEg	Hej Monika Remix	PewDiePie	rm
5dQYXAEF7lE	Phantom Liberty	Dawid Podsiadło, P.T. Adamczyk	rm
LLbew85exp0	Piano Man	Billy Joel	rm
caNkiL2dVMA	Bałkanica	Piersi	rm
2dbR2JZmlWo	KILL YOURSELF	Filthy Frank	rm
GhJ043zp8hI	STFU	Filthy Frank	rm
v2vWDWxYJBc	Pink Triangle	Weezer	rm
xqHKc-YU7aU	Pisarz Miłości	Bracia Figo Fagot	rm
knKpze7gRWc	Płacze moje serce	Sandra Mika	rm
6UOHkrNYFMY	Po co wolność	Kult	rm
Ktx3sKoyoJU	Podobno tego nie robiła	Bracia Figo Fagot	rm
PmEgP8IfliM	Polibuda	Lej Mi Pół	rm
q9MAIwJMc1U	Polka Ewy	Canta Rhei	rm
_PpfJUDGyBI	Polonez	Pan Tadeusz	rm
iRVCWeDfujY	Polska	Bracia Figo Fagot	rm
6i8JDcyFJV4	Byłaś dla mnie wszystkim	Poparzeni Kawą Trzy	rm
dFR6VoUdoTo	Pressure	Billy Joel	rm
9bZkp7q19f0	Gangnam Style	Psy	rm
nbCOAPR33ME	Karma Police	Radiohead	rm
sySlY1XKlhM	Raindrops Keep Falling on my Head	B.J. Thomas	rm
06-l1yaJ1Y8	Rapapara	Łydka Grubasa	rm
4ZpekM2Zlbo	Rapture	Soldier Boy	rm
Sw9X43IerL0	Friday	Rebecca Black	rm
5Z0dxsFmX7c	Rasputin	Boney M.	rm
7ojDCs-f380	Repeat Stuff	Bo Burnham	rm
lYBUbBu4W08	Never Gonna Give You Up	Rick Astley	rm
v4hFHWcunr0	Rise Guys	The Chalkeaters	rm
dk0JaemOLwQ	Rockefeller Street	Getter Jaani	rm
pOkLlpSlbvc	Roll out the Fallout!	The Chalkeaters	rm
pk3HBb0mh5Q	Roundabout	Yes	rm
ruana7nJFUY	Riptide	Vance Joy	rm
c7O91GDWGPU	William Tell Overture: Final	Gioachino Rossini	rm
At8ao5iABFg	Ruler of Everything	Tally Hall	rm
BJ0xBCwkg3E	Running in the 90's	Max Coveri	rm
gyHh63zJQw4	Sad	Bo Burnham	rm
jWpZuFM0Qtk	Safe and Sound	Capital Cities	rm
hgoSlepPeq8	Szary świat	sanah, Kwiat Jabłoni	rm
TvakQUQhCkg	Sardines	Kid Kapichi	rm
68chm7PkPbM	Sąsiad	Lej Mi Pół	rm
4neXNZyChkY	Say It Ain't So	Weezer	rm
7neipvZ_H0c	Scatman's World	Scatman John	rm
Eht9W25tDZo	Scatman (ski-ba-bop-ba-dop-bop)	Scatman John	rm
i3-XSmoMWXc	Scenariusz dla moich sąsiadów	Myslovitz	rm
GjDfnE08ewg	Seijaku no Apostle	Jonathan Young	rm
lMKY5NSdbns	Seksualna czekolada	Afro Kolektyw	rm
Ucmo6hDZRSY	Self Control	Laura Branigan	rm
RZspOHtpPyY	She sells sea shells on the sea shore	Doge Devito Productions	rm
ZSRzCbpIxZo	Snowman	Sia	rm
-eqJGVl0Pr0	The Sounds of Silence	Simon & Garfunkel	rm
0wayGmHC6iU	Skibidi Toilet GONI MNIE	przemekbestgames	rm
0rTmVjPqK68	Skibidi Bop Yes Yes Yes x Bloody Mary	Cookie Memes	rm
t-oGdkl8YEc	I'm A Believer	Smash Mouth	rm
mRNcPbCJNJ8	Smooth Operator	Sade	rm
xOazTYPrt64	Somebody That I Used To Know	Gotye, Kimbra	rm
LWXUdqvVO8Y	Somethin' Stupid	Frank Sinatra, Nancy Sinatra	rm
aBKEt3MhNMM	Starman	David Bowie	rm
ugUb4vuSSUI	Star Wars is kinda gay	Rucka Rucka Ali	rm
qflJJO3V6aE	Still Alive	Aperture Science Psychoacoustic Laboratories	rm
ffmOr4-bbbA	Stronger (What Doesn't Kill You)	Kelly Clarkson	rm
uFPu4Gfau2o	Subway Sexists	Yung Spinach Cumshot	rm
rDHzx3aMLxY	Symetryczno-liryczna	Enej	rm
PBmtJvIcFXI	Skrzydlate Ręce	Enej	rm
oMfMUfgjiLg	Sweet Child O' Mine	Guns N' Roses	rm
RQjHCOmwlgQ	Świnki i Damy	Bracia Figo Fagot	rm
d11xns8lE4w	Take Me Out	Franz Ferdinand	rm
HzdD8kbDzZA	Take on Me	a-ha	rm
GmSNx9h3d_E	Takie ładne oczy	Czerwone Gitary	rm
-5GI38vWew8	Taste	Sabrina Carpenter	rm
VIv7x1SmsCs	Blank Space PARODY	Bart Baker	rm
__4H4O4Z9Hw	Teresa	Bracia Figo Fagot	rm
HOfU-vXiKLQ	The Android Hell Blues	Harry Callaghan	rm
ipYafcHd0jA	The Bidding	Tally Hall	rm
_ru0VHLumdI	The FCC Song	Family Guy	rm
Il7y6VwDrrw	The LEGO Ninjago Movie The Weekend Whip (Original Soundtrack)	Ninjago Music, The Fold	rm
weqK155M_4o	You're Gonna Go Far, Kid	The Offspring	rm
oUv0NbjbGzQ	I'm Gonna Be (500 Miles)	Dig!	rm
r5QW0d8cNek	The Ultimate Showdown of Ultimate Destiny	Lemon Demon	rm
ivZFY7o_-QU	THE HERO	Jam Project 	rm
XMCYNH1EJTg	THE HERO Cover	Jonathan Young	rm
J7p4bzqLvCw	Blinding Lights	The Weeknd	rm
D_QLxj8jCF0	Seven Nation Army	The White Stripes	rm
37GLz88_w44	They Say	Daron Malakian and Scars On Broadway	rm
VSGyiYLQwhY	This fffire	Franz Ferdinand	rm
BwYaH5u0lMs	This is my kingdom come	Tactical	rm
zQUn0l4Vh2s	Threw It On The Ground	The Lonely Island	rm
DZyYapMZSec	Through The Fire And Flames	DragonForce	rm
HnnIOJVmY4A	Tick Tock	Joji	rm
pc4aIMwKV4k	Treat Jew Better	Rucka Rucka Ali	rm
RQmEERvqq70	Everybody's Circulation	TMABird	rm
z69C2Jqp42Q	Toccata and Fugue in D Minor	Johann Sebastian Bach	rm
pS5d77DQHOI	Tokyo Drift	Teriyaki Boyz	rm
tVdr_JWmnsA	Toxic	Britney Spears	rm
5Q6ccOMOFeU	Da Da Da	Trio	rm
MWzb9nXsx3s	Trofea	Dawid Podsiadło	rm
KrXJu-6ZcAQ	Turn the Lights Off	Tally Hall	rm
QUZusUkmxoE	Typ Niepokorny	Stachursky	rm
G-e8ZhzNjcY	Ugi Boogie	Bracia Figo Fagot	rm
5hr2eFnarak	Uncrowned greatest hero	JAM Project	rm
0FCvzsVlXpQ	Megalovania	Undertale	rm
ONhfmrKJ5kE	The Sweater Song	Weezer	rm
PNoIn1WKiEc	A Thousand Miles	Vanessa Carlton	rm
53LY9fBzrXM	Astronomia	Vicetone	rm
3a-q7vPa-UU	Viva La Vida	Coldplay	rm
LJCLUhBzBM8	Variations on the cloud	Miracle Musical	rm
sVXsZhB7E9k	Wędkarz miłości	Bracia Figo Fagot	rm
M5EgMhITQN4	We Don't Talk About Bruno	Sus Version	rm
Z6gvqm6gud4	Wędrowny Druciarz	Lej Mi Pół	rm
vcaPiiFZu2o	Ocean Man	Ween	rm
CLW3FnDa1nQ	Welcome to the Internet	Bo Burnham	rm
D458Eaql_aQ	Wellerman (Sea Shanty)	Nathan Evans	rm
wWe4SgaaxKM	Wesele	Bracia Figo Fagot	rm
Mqvc00qu-3Y	what can i say except the n word	Talking Nonsense	rm
dEOmR6b0IqM	What Is Love	Haddaway	rm
eXRWHzV72sU	What I've Done	Linkin Park	rm
mQYJYY4VkWA	Why Don't You Get A Job	The Offspring	rm
u5heWZ9occg	Wild Side	ALI	rm
o6D4-u_hiV4	Wódko, wódeczko	Cjalis	rm
qjX_SLyiids	Wojownicy Wódy	Bracia Figo Fagot	rm
lShwACiPkzc	Wykończeniówka	Cjalis	rm
rH6BjUM_Khg	The Fox (What Does The Fox Say)	Ylvis	rm
Aqc3VTpz9HQ	You Give Love A Bad Name	Bon Jovi	rm
7Do70nztRNE	Your Cum Won't Last	OblivionFall	rm
4feUSTS21-8	You reposted in the wrong neighborhood	Shokk Bloo	rm
gvYfRiJQIX8	You've Been Trolled	Ray Francis Films 	rm
B-Dk0tQeWHg	You've Got a License to Drive (Me Crazy)	Miles Gaston Villanueva	rm
ViZjSY6Kv8A	Zakochany delfin	Bracia Figo Fagot	rm
RbwjVuh9x4g	Zalegizybać Marihuaen	Bracia Figo Fagot	rm
7NZR9k72L9o	Znowu Mam Bana	Blowek	rm
v2g5wWE4w44	Zobacz Dziwko Co Narobiłaś	Bracia Figo Fagot	rm
k0NAarafxzw	Коробейники (Korobeiniki)	theonewhoCheekiBreeki	rm
LEhoQoyLtUo	Коробейники	Les Choeurs de L'Armée Rouge	rm
mJ1N7-HyH1A	夜に駆ける	YOASOBI, Ayase	rm
